20 20
200 200
1 1 1 1 1 1 1 1 1 1 1 1 1 1 1 1 1 1 1 1
1 0 0 0 0 0 0 0 0 0 0 0 0 0 0 0 0 0 0 1
1 0 2 2 2 2 2 2 2 2 2 2 2 0 0 0 0 0 0 1
1 0 2 0 0 0 0 0 0 0 0 0 2 0 0 0 0 0 0 1
1 0 2 0 3 0 4 0 0 4 0 0 2 0 0 0 0 0 0 1
1 0 2 0 3 0 4 0 0 4 0 0 2 0 0 0 0 0 0 1
1 0 2 0 0 0 0 0 0 0 0 0 2 0 0 0 0 0 0 1
1 0 2 0 0 0 0 0 0 0 0 0 2 0 0 0 0 0 0 1
1 0 2 0 5 5 5 0 0 0 0 0 2 0 0 0 0 0 0 1
1 0 2 0 5 0 5 0 0 0 0 0 2 0 0 0 0 0 0 1
1 0 2 0 0 0 0 0 0 0 0 0 2 0 0 0 0 0 0 1
1 0 2 2 2 2 2 2 2 2 2 2 2 0 0 0 0 0 0 1
1 0 0 0 0 0 0 0 0 0 0 0 0 0 0 0 0 0 0 1
1 0 0 0 0 0 0 0 0 0 0 0 0 0 0 0 0 0 0 1
1 0 0 0 0 0 0 0 0 0 0 0 0 0 0 0 0 0 0 1
1 0 0 0 0 0 0 0 0 0 0 0 0 0 0 0 0 0 0 1
1 0 0 0 0 0 0 0 0 0 0 0 0 0 0 0 0 0 0 1
1 0 0 0 0 0 0 0 0 0 0 0 0 0 0 0 0 0 0 1
1 0 0 0 0 0 0 0 0 0 0 0 0 0 0 0 0 0 0 1
1 1 1 1 1 1 1 1 1 1 1 1 1 1 1 1 1 1 1 1